1111111111111111111111111111111111111111
1000010000000100000000000001000000111111
1000010000000100000000000001000000011111
1000000001000100001100001001000000001111
1000000001000100111000011000000000000111
1111111111000100100000111000001110000011
1000010001000000000001111000111100000001
1000010001000000000011111111100100000001
1000010001111111111111010100011111000011
1001111101000101010001010100010101000011
1001010100000001000000010000000100000011
1100010000000000000000000000000000000111
1100000000010000000100000001000000000111
1100000001111100011111000111110001000111
1000000001010100010101000101010001000111
1000111111111111111111111111111111111111
1000100000000000000000100000001000000001
1000100000000000000000100000001000000001
1000100011111111111000100010001000110001
1000100000000100000000100010001000110001
1000100000000100000000100010001000110001
1000111111100100011111100010001000111001
1000011000000100000000000010001000111001
1100001100000100000000000010001000111001
1110000110011111111111111110001000110001
1111000010000100000000000000001000110001
1111100000000100000000000000001000110001
1111110000000100001111111111111000110011
1111111000000110000000000001111000110011
1111111100000111000000000000000000110000
1111111110000111111111100000000000110000
1111111111111111111111111111111111111111